Map1
36
1 1 0 30 544 33 0 
2 1 580 42 28 10 0 
3 1 645 42 28 10 0 
4 1 710 42 28 10 0 
5 1 775 42 28 10 0 
6 1 802 74 30 16 0 
7 1 835 105 128 9 0 
8 1 1027 42 63 10 0 
9 1 1124 30 286 33 0 
10 1 1218 108 32 5 0 
11 1 1283 108 95 5 0 
12 1 1411 73 31 9 0 
13 1 1443 105 31 9 0 
14 1 1475 137 63 9 0 
15 1 1600 42 18 9 0 
16 1 1665 42 18 9 0 
17 1 1728 42 18 9 0 
18 1 1796 30 270 33 0 
19 2 250 70 1 1 1 
20 2 300 70 1 1 1 
21 2 450 70 1 1 1 
22 2 350 70 1 1 1 
23 2 1300 140 1 1 1 
24 2 1450 140 1 1 1 
25 2 1500 170 1 1 1 
26 2 632 145 20 16 3 
27 2 240 70 34 15 4 
28 2 890 130 34 15 4 
29 2 940 130 34 15 4 
30 2 1260 150 24 15 4 
31 2 565 120 1 1 2 
32 2 668 120 1 1 2 
33 2 813 110 1 1 13 
34 2 500 70 1 1 14 
35 2 400 70 1 1 11 
36 2 350 70 1 1 12 
// id loai | x y w h miniType
chu y ket thuc moi dong phai co 1 dau cach
// cai nao khong biet thi de la 0
//miniType la type trong type...VD Type enemy gom nhieu miniType nhu NguoiCamKiem, Bat, Tiger...

//Loai 1: ground
//Loai 2: enemy
	miniType 1: NguoiCamKiem
		 3: Bat
		 4: Panther
	
	
	
	
	
