Map1 49
49
1 1 0 42 544 33 0 
2 1 580 42 28 10 0 
3 1 645 42 28 10 0 
4 1 710 42 28 10 0 
5 1 775 42 28 10 0 
6 1 802 74 30 16 0 
7 1 835 106 128 9 0 
8 1 1027 42 63 10 0 
9 1 1124 42 286 33 0 
10 1 1218 110 32 10 0 
11 1 1283 110 95 10 0 
12 1 1411 74 31 9 0 
13 1 1443 106 31 9 0 
14 1 1475 138 63 9 0 
15 1 1600 42 18 9 0 
16 1 1665 42 18 9 0 
17 1 1728 42 18 9 0 
18 1 1796 42 270 33 0 
19 2 250 80 1 1 1 
20 2 300 80 1 1 1 
21 2 450 80 1 1 1 
22 2 350 80 1 1 1 
23 2 1300 140 1 1 1 
24 2 1450 140 1 1 1 
25 2 1500 170 1 1 1 
26 2 632 145 20 16 3 1 
27 2 240 80 34 15 4 1 
28 2 890 130 34 15 4 -1 
29 2 940 130 34 15 4 1 
30 2 1260 150 24 15 4 -1 
31 2 565 155 1 1 2 
32 2 728 155 1 1 2 
33 2 820 120 1 1 13 
34 2 1370 90 1 1 14 
35 2 1890 80 1 1 1 
36 2 1970 80 1 1 1 
37 2 1870 148 1 1 2 
38 2 1735 148 1 1 2 
39 2 1230 138 1 1 13 
40 2 1060 148 1 1 2 
41 2 40 100 1 1 15 1 
42 2 70 100 1 1 15 2 
43 2 100 100 1 1 15 3 
44 2 130 100 1 1 15 4 
45 2 160 100 1 1 15 5 
46 2 190 100 1 1 15 6 
47 2 210 100 1 1 15 7 
48 2 230 100 1 1 15 8 
49 2 260 100 1 1 15 9 
// id loai | x y w h miniType other
chu y ket thuc moi dong phai co 1 dau cach
// cai nao khong biet thi de la 0
//miniType la type trong type...VD Type enemy gom nhieu miniType nhu NguoiCamKiem, Bat, Tiger...

//Loai 1: ground	minitype 0: binh thuong, di xuyen <- -> duoc
		minitype 1: khong di xuyen <- -> duoc
//Loai 2: enemy
	miniType 1: NguoiCamKiem
		 3: Bat
		 4: Panther
	