Map2
50
1 1 0 40 260 15 1 
2 1 265 70 160 15 1 
3 1 425 100 155 15 1 
4 1 580 134 155 15 1 
5 1 805 38 30 15 1 
6 1 870 72 27 15 1 
7 1 930 100 30 15 1 
8 1 960 36 145 15 1 
9 1 1095 136 87 15 1 
10 1 1155 38 94 15 1 
11 1 1220 134 90 15 1 
12 1 1280 68 70 15 1 
13 1 1375 35 70 15 1 
14 1 1310 105 295 15 0 
15 1 1472 68 70 15 1 
16 1 1570 35 125 15 1 
17 1 1605 134 155 15 1 
18 1 1827 37 31 15 1 
19 1 1895 134 55 15 1 
20 1 1987 68 30 15 1 
21 1 2052 68 95 15 1 
22 1 2145 100 95 20 1 
23 1 2245 38 95 15 1 
24 1 2340 68 60 15 1 
25 1 2400 38 100 15 1 
26 1 2500 68 95 15 1 
27 1 2600 38 60 15 1 
28 1 2660 68 60 15 1 
29 1 2725 100 155 15 1 
30 1 2950 38 120 15 1 
31 1 1860 105 30 5 0 
32 1 1060 100 30 5 0 
33 3 714 123 20 123 0 
34 3 805 32 30 32 0 
35 3 870 62 27 62 0 
36 3 930 96 30 96 0 
37 3 1095 130 10 105 1 
38 3 1174 130 10 55 2 
39 3 1220 130 10 55 3 
40 3 1745 126 15 40 2 
41 3 1827 30 31 30 0 
42 3 1895 126 10 100 1 
43 3 1940 126 10 126 2 
44 3 1987 62 30 62 0 
45 3 2052 60 10 60 3 
46 3 2230 87 10 56 2 
47 3 2870 90 10 90 2 
48 3 2950 28 10 28 3 
49 1 1100 124 10 124 1 
50 3 1717 45 10 45 2 


//
50 1 1223 130 10 55 1 