Map2
73
1 1 0 40 260 15 1 
2 1 265 70 160 15 1 
3 1 425 100 155 15 1 
4 1 580 134 155 15 1 
5 1 805 38 30 15 1 
6 1 870 72 27 15 1 
7 1 930 100 30 15 1 
8 1 960 36 145 15 1 
9 1 1095 136 87 15 1 
10 1 1155 38 94 15 1 
11 1 1220 134 90 15 1 
12 1 1280 68 70 15 1 
13 1 1375 35 70 15 1 
14 1 1310 105 295 15 0 
15 1 1472 68 70 15 1 
16 1 1570 35 125 15 1 
17 1 1605 134 155 15 1 
18 1 1827 37 31 15 1 
19 1 1895 134 55 15 1 
20 1 1987 68 30 15 1 
21 1 2052 68 95 15 1 
22 1 2145 100 95 20 1 
23 1 2210 38 130 30 1 
24 1 2340 68 60 15 1 
25 1 2400 38 100 15 1 
26 1 2500 68 95 15 1 
27 1 2600 38 60 15 1 
28 1 2660 68 60 15 1 
29 1 2725 100 155 15 1 
30 1 2950 38 120 15 1 
31 1 1860 105 30 5 2 
32 1 1060 100 30 5 2 
33 3 714 123 20 123 0 
34 3 805 32 30 32 0 
35 3 870 62 27 62 0 
36 3 930 96 30 96 0 
37 3 1095 130 10 105 1 
38 3 1174 130 10 55 2 
39 3 1220 130 10 55 3 
40 3 1745 126 15 40 2 
41 3 1827 30 31 30 0 
42 3 1895 126 10 100 1 
43 3 1940 126 10 126 2 
44 3 1987 62 30 62 0 
45 3 2052 60 10 60 3 
46 3 2210 87 30 56 2 
47 3 2870 90 10 90 2 
48 3 2950 28 10 28 3 
49 1 1100 124 10 124 1 
50 3 1717 45 10 45 2 
51 2 310 110 1 1 1 
52 2 400 110 1 1 1 
53 2 530 110 1 1 11 
54 2 660 158 1 1 11 
55 2 880 110 1 1 1 
56 2 1070 80 1 1 13 
57 2 1160 80 1 1 1 
58 2 1230 80 1 1 1 
59 2 1170 170 1 1 13 
60 2 1500 110 1 1 11 
61 2 1580 140 1 1 12 
62 2 1620 170 1 1 12 
64 2 1910 170 1 1 1 
65 2 2100 95 1 1 11 
66 2 2290 70 1 1 11 
67 2 2475 70 1 1 11 
68 2 2400 160 1 1 2 
69 2 2690 100 1 1 11 
70 2 2740 120 1 1 4 
71 2 2670 170 1 1 2 
72 2 3000 170 1 1 2 
73 2 2980 70 1 1 1 
74 2 1425 170 1 1 2 
//-1 ra
50 1 1223 130 10 55 1
