Map2
32
1 1 0 40 260 15 0 
2 1 265 70 160 15 0 
3 1 425 100 155 15 0 
4 1 580 134 155 15 0 
5 1 805 38 30 15 0 
6 1 870 72 30 15 0 
7 1 930 100 30 15 0 
8 1 960 36 145 15 0 
9 1 1100 134 90 15 0 
10 1 1155 38 90 15 0 
11 1 1220 134 90 15 0 
12 1 1280 68 60 15 0 
13 1 1380 38 60 15 0 
14 1 1320 100 285 15 0 
15 1 1475 68 60 15 0 
16 1 1570 38 125 15 0 
17 1 1605 134 155 15 0 
18 1 1825 38 35 15 0 
19 1 1895 134 60 15 0 
20 1 1985 68 35 15 0 
21 1 2050 68 95 15 0 
22 1 2150 100 95 50 0 
23 1 2245 38 95 15 0 
24 1 2340 68 60 15 0 
25 1 2400 38 100 15 0 
26 1 2500 68 95 15 0 
27 1 2600 38 60 15 0 
28 1 2660 68 60 15 0 
29 1 2725 100 155 15 0 
30 1 2950 38 120 15 0
31 1 1860 100 30 5 0  
32 1 1060 100 30 5 0 
